NO ./sprites/Wall1.xpm
SO ./sprites/Wall2.xpm
WE ./sprites/Wall3.xpm
EA ./sprites/Wall4.xpm

F 220,100,200
C 10,20,200

        1111111111111111111111111
        1000000000110000000000001
        1011000001110000000000001
        1001000000000000000000001
111111111011000001110000000000001
100000000011000001110111110111111
11110111111111011100000010001
11110111111111011101010010001
11000000110101011100000010001
100000000000000011000000110111
10000000000000001101010010001
11000001110101011111011100N001
11110111 1110101 101111010001
11111111 1111111 111111111111
